###########
#...$.$...#
#.........#
#.........#
#.........#
#####X#####
