      #####XX######
    ##.............##
  ###.................##
#.......................####
#.........#..#.............##
#..........##..............##
 #.................########
  ####.....##########
      #####
