##################################
#................................#
X...................$............#
X...................$............#
#................................#
##################################
